ID	Sequence
Secreted_OUL_CU	SDSYDPCTGLLQKSPQCCNTDILGVANLDCHGPPSVPTSPSQFQASCVADGGRSARCCTLSLLGLALVCTDPVGI
Secreted_POS_VMH2	IPRTDTPSCSTGSLQCCSSVQKATDPLASLLIGLLGIVLGPLDLLVGVTCSPITVIGVGGTSCTQQTVCCTGNSFNGLIAIGCSPINISL
Secreted_SCOM_SC3	GGHPGTTTPPVTTTVTVTTPPSTTTIAAGGTCTTGSLSCCNQVQSASSSPVTALLGLLGIVLSDLNVLVGISCSPLTVIGVGGSGCSAQTVCCENTQFNGLINIGCTPINIL
Secreted_XPA_XPH1	TTPGQSIQNQCSQGQTAKCCNSLSKAVANLIPIQIGLNCVSLDLISVLPIGKQCTQSQALACCSSGQQTGLVNLGNVCVPVSL
Secreted_SCOM_SC4	AGQACNSGPVQCCNETTTVANAQKQGLLGGLLGVVVGPITGLVGLNCSPISVVGVLTGNSCTAQTVCCDHVTQNGLVNVGCTPISL
Secreted_SCOM_SC16	TAVPRDVNGGTPPKSCSSGPVYCCNKTEDSKHLDKGTTALLGLLNIKIGDLKDLVGLNCSPLSVIGVGGNSCSAQTVCCTNTYQHGLVNVGCTPINIGL
Secreted_ANI_DewA	SLPASAAKNAKLATSAAFAKQAEGTTCNVGSIACCNSPAETNNDSLLSGLLGAGLLNGLSGNTGSACAKASLIDQLGLLALVDHTEEGPVCKNIVACCPEGTTNCVAVDNAGAGTKAE
Unsecreted_AFU_RodE	MHPRPEHLSPTLNHNHRLKLKQPATTSRMLARTILATLVSAACFATVNAQTCSATNAVCCQQLQDPDNLNADALNLLRLLNINPNTLTGAVGLTCKRLTEACFACLLLTRPGTSLVSGSCNANAACCTGNNYNGLIVLGCTQIQ
Secreted_GFR_HGF1	TPVRRQQCTTGQLQCCESTSTANDPATSELLGLIGVVISDVDALVGLTCSPISVIGVGSGSACTANPVCCDSSPIGGLVSIGCVPVNV
Secreted_TAS_TasHyd1	SPVQEAEVAPRAIEPRMPTFADIPFPRFPSHNNHHHNEKDKGKDKGNGKGVDKNNGGGCDTGTNTQLNACSAGSPYCCSSDGNGGHICSNTTACDQKVICCNNNNGFQICIGEIDFNVPGTINIIYD
Secreted_MAN_SSG1	QPSSNEMNCDSGVYCCNKVAQNTGIVVPIDALSSTCGDTLKLVTVDALNDKCTSQTVCCNNVQQNGLVNVACTPIDV
Secreted_CFU_TH1	VPTSSGGSCRPRPPPGGGNGGNGGNGGNGGNGYQPCPAGLYSNPQCCATDVLGVADLDCKNPSSAPMSGDNFKSICNAVGQQAKCCVLPVAGQAVLCQDSINGGGNGGNNGGNGGNNGGNGGNNGGNTDYPGGNGGNNGGNNGGNNGGNNGGNNGGNNGGNNGGNNGGNNGGNNGGNGGNGGNGYQACPAGLLYSNPQCCSTGVLGVADLDCKNPSSAPTSGDDFQKICANGGQQAQCCSIPVAGQAVLCQPAIGGGNPGGNGGNNGGNGGNGGNNGGNNGGNGDYPGGNGGNNGGSNGGGNGGNGGNGGSFKCPSGLYSVPQCCATDVLGVADLDCGNPSRQPTDSSDFASVCAAKGQRARCCVLPLLGQAVLCTGA
Secreted_CPA_CRP	GGGGGGSGSGSGSGSGSGSGGGSTTYTACSSTLYSEAQCCATDVLGVADLDCETVPETPTSASSFESICATSGRDAKCCTIPLLGQALLCQDPVGL
Secreted_MOR_MHP1	LPAEVQERQVPYTPCSGLYGSAQCCATDILGLANLDCGQPSDAPVDADNFSEICAAIGQRARCCVLPILDQGILCNTPAGVTP
Unsecreted_AFU_RodD	MPHFCLVASTSMLSASYDVSQDLSSALYTSSSTYKYESASARIDCLSTTCTQVLKTLEIEHKLSMKVFATLFLLAASATAALAAVPAPNAGCSQPGQYCNGGTFLCCNNRQCNNNVRVPYSVPGYARNPSYAFSRHHGRNGSSQLSMSIWDALEELLVSGGDWVSYNQWAKYEAGARVVGTIHERRGMNEID
Secreted_AFU_RodG	EDPTMSALKSRVEEIAGQVHGVEDQETTPDLSHCVEPKLCCGSLTTPLDPILDPILLSLGINAAQIVGSVGLLCHPWTEECSSAPQCCTEANLLGGTLALGCSKL
Secreted_AFU_RodE	QTCSATNAVCCQQLQDPDNLNADALNLLRLLNINPNTLTGAVGLTCKRLTEACFACLLLTRPGTSLVSGSCNANAACCTGNNYNGLIVLGCTQIQ
Secreted_AFU_RodC	LPSLQVIPRGEPQLPLLDPSMTIKEAARKCGDKAQLSCCNRVVKAGDYTSVDEGIGAGLLSNLAGGGSGISSILAFDQCSRLDAQVPVVLLPIQDLLNQHCKQNVACCQKNPGDASSSGVGVSLPCIALGSVA
Secreted_AFU_RodB	LPNAGVVHPTFASADKYTLQQAQNKCGEHTTLSCCNHVSKVGDTTAFNYGLLNGLLGNAISGPEGVGILSGCQKISVTALIGVDDLLNKQCQQNVACCQDNKSVATGGLINIATPACVALDSII
Secreted_AFU_RodF	VPFSQASKSTSASRSTSSSTVPASLPSPTLSGPNACPPNKFKQCCTTLSQVGDDLLKPLGAVVPLVGAIQVNSLVGVSCRPMADAAPESTCGNAVMCCDSSTVGGDDLMQTSCQDFALAKKREREAIERQQRRFSEYQRMMLSQSATPAPTSTGVDVMGSSFSKAKATPTRV
Secreted_AFU_RodA	LPQHDVNAAGNGVGNKGNANVRFPVPDDITVKQATEKCGDQAQLSCCNKATYAGDVTDIDEGILAGTLKNLIGGGSGTEGLGLFNQCSKLDLQIPIIGIPIQDLVNQKCKQNIACCQNSPSDASGSLIGLGLPCIALGSIL
Secreted_MOR_MPG1	SAIPAPGEGPSVSMAQQKCGAEKVVSCCNSKELKNSKSGAEIPIDVLSGECKNIPINILTINQLIPINNFCSDTVSCCSGEQIGLVNIQCTPILS
Secreted_NCR_EAS	ATTIGPNTCSIDDYKPYCCQSMSGPAGSPGLLNLIPVDLSASLGCVVGVIGSQCGASVKCCKDDVTNTGNSFLIINAANCVA
Secreted_PCA_HYDX	GQCSTGSIQCCQNVVPGDSDLGTLLLDELGIVLEDPTVLIGDGCDPITVAGSSDACSATAVCCSDNNVSGVIAIGCLPVTL
Secreted_NCR_NC2	SPAAMERQVPYTPCSGLYGTAQCCATDVLGVADLDCANPPATLANATHFESTCAAIGQRARCCVLPILGQDILCQTPAGL
Secreted_SLA_HYDX	GSSQCNAGPVQCCNTLTSASNSQAAGLIQQLGLSGVGANVPVGINCNPITGIGAGSGSSCNANPACCDNVYTNGLGVQCNPINVNL
Secreted_TRE_HFBI	SNGNGNVCPPGLFSNPQCCATQVLGLIGLDCKVPSQNVYDGTDFRNVCAKTGAQPLCCVAPVAGQALLCQTAVGA
Secreted_TRE_HFBII	AVCPTGLFSNPLCCATNVLDLIGVDCKTPTIAVDTGAIFQAHCASKGSKPLCCVAPVADQALLCQKAIGTF
Secreted_WIC_HYDX	GWESKTGSCNTGKLACCDTNKKVQKSTGEESGLLHTGDVLDQVAIQCTQIPLLIGIAIEDECKNTPTCCEDVEDDGLVGINCTPIPLI